




SO    ./Textures/1.xpm

EA   ./Textures/2.xpm

NO       ./Textures/3.xpm

WE   ./Textures/4.xpm




F              0,100,233


C   210,33,200




        1111111111111111111111111
        1000000000110000000000001
        1011000001110000000000001
10010000000000000000000011     11
111111111011000001110000000000001
100000000111000001110111111111111
11110111111111011110000000001
11110111111111011101010010001
11000000110101011100000010001
10000000000000001100000010001
100000E0010000001101010010001
1100000111010101111101111000111
11110111 1110101 101111010001
11111111 1111111 111111111111
