11111111111111111111111111111111111111111111111111111111111111111111111111111111111111111111111111111111111111
11111111111111111111111111111100000000000000000000000000000000000000000000000000111111111111111111111111111111
11111111111111111111111111111100000000000000000000000000000000000000000000000000111111111111111111111111111111
11111111111111111111111111111100000000000000000000000000000000000000000000000000111111111111111111111111111111
11111111111111111111111111111100000000000000000000000000000000000000000000000000111111111111111111111111111111
11111111111111111111111111111100000000000000000000000000000000000000000000000000111111111111111111111111111111
11111111111111111111111111111100000000000000000000000000000000000000000000000000111111111111111111111111111111
11111111111111111111111111111100000000000000000000000000000000000000000000000000111111111111111111111111111111
11111111111111111111111111111100000000000000000000000000000000000000000000000000111111111111111111111111111111
11111111111111111111111111111100000000000000000000000000000000000000000000000000111111111111111111111111111111
11111111111111111111111111111100000000000000000000000000000000000000000000000000111111111111111111111111111111
11111111111111111111111111111100000000000000000000111111111100000000000000000000111111111111111111111111111111
11111111111111111111111111111100000000000000000000111111111100000000000000000000111111111111111111111111111111
11111111111111111111111111111100000000000000000000111111111100000000000000000000111111111111111111111111111111
11111111111111111111111111111100000000000000000000111111111100000000000000000000111111111111111111111111111111
11111111111111111111111111111100000000000000000000111111111100000000000000000000111111111111111111111111111111
11111111111111111111111111111100000000000000000000111111111100000000000000000000111111111111111111111111111111
11111111111111111111111111111100000000000000000000111111111100000000000000000000111111111111111111111111111111
11111111111111111111111111111100000000000000000000111111111100000000000000000000111111111111111111111111111111
11111111111111111111111111111100000000000000000000111111111100000000000000000000111111111111111111111111111111
11111111111111111111111111111100000000000000000000111111111100000000000000000000111111111111111111111111111111
11111111110000000000000000000000000000000000000000000000000000000000000000000000000000000000000000001111111111
11111111110000000000000000000000000000000000000000000000000000000000000000000000000000000000000000001111111111
11111111110000000000000000000000000000000000000000000000000000000000000000000000000000000000000000001111111111
11111111110000000000000000000000000000000000000000000000000000000000000000000000000000000000000000001111111111
11111111110000000000000000000000000000000000000000000000000000000000000000000000000000000000000000001111111111
11111111110000000000000000000000000000000000000000000000000000000000000000000000000000000000000000001111111111
11111111110000000000000000000000000000000000000000000000000000000000000000000000000000000000000000001111111111
11111111110000000000000000000000000000000000000000000000000000000000000000000000000000000000000000001111111111
11111111110000000000000000000000000000000000000000000000000000000000000000000000000000000000000000001111111111
111111111100000000000000000000000000000000000000000S0000000000000000000000000000000000000000000000001111111111
11111111111111111111111111111111111111111111111111111111111111111111111111111111111111111111111111111111111111
