11111111111111111111111111111111111111111111111111111111111111111111111111111111111111111111111111111111111111
11111111111111111111111111111100000000000000000000000000000000000000000000000000111111111111111111111111111111
11111111111111111111111111111100000000000000000000000000000000000000000000000000111111111111111111111111111111
11111111111111111111111111111100000000000000000000000000000000000000000000000000111111111111111111111111111111
11111111111111111111111111111100000000000000000000000000000000000000000000000000111111111111111111111111111111
11111111111111111111111111111100000000000000000000000000000000000000000000000000111111111111111111111111111111
11111111111111111111111111111100000000000000000000000000000000000000000000000000111111111111111111111111111111
11111111111111111111111111111100000000000000000000000000000000000000000000000000111111111111111111111111111111
11111111111111111111111111111100000000000000000000000000000000000000000000000000111111111111111111111111111111
11111111111111111111111111111100000000000000000000000000000000000000000000000000111111111111111111111111111111
11111111111111111111111111111100000000000000000000000000000000000000000000000000111111111111111111111111111111
11111111111111111111111111111100000000000000000000111111111100000000000000000000111111111111111111111111111111
11111111111111111111111111111100000000000000000000111111111100000000000000000000111111111111111111111111111111
11111111111111111111111111111100000000000000000000111111111100000000000000000000111111111111111111111111111111
11111111111111111111111111111100000000000000000000111111111100000000000000000000111111111111111111111111111111
11111111111111111111111111111100000000000000000000111111111100000000000000000000111111111111111111111111111111
11111111111111111111111111111100000000000000000000111111111100000000000000000000111111111111111111111111111111
11111111111111111111111111111100000000000000000000111111111100000000000000000000111111111111111111111111111111
11111111111111111111111111111100000000000000000000111111111100000000000000000000111111111111111111111111111111
1111111111111111111111111111110000000000000000000S111111111100000000000000000000111111111111111111111111111111
11111111111111111111111111111100000000000000000000111111111100000000000000000000111111111111111111111111111111
1111111111000000000000000000000000000000000000000000000S000000000000000000000000000000000000000000001111111111
11111111110000000000000000000000000000000000000000000000000000000000000000000000000000000000000000001111111111
11111111110000000000000000000000000000000000000000000000000000000000000000000000000000000000000000001111111111
11111111110000000000000000000000000000000000000000000000000000000000000000000000000000000000000000001111111111
11111111110000000000000000000000000000000000000000000000000000000000000000000000000000000000000000001111111111
11111111110000000000000000000000000000000000000000000000000000000000000000000000000000000000000000001111111111
11111111110000000000000000000000000000000000000000000000000000000000000000000000000000000000000000001111111111
11111111110000000000000000000000000000000000000000000000000000000000000000000000000000000000000000001111111111
11111111110000000000000000000000000000000000000000000000000000000000000000000000000000000000000000001111111111
11111111110000000000000000000000000000000000000000000000000000000000000000000000000000000000000000001111111111
11111111111111111111111111111111111111111111111111111111111111111111111111111111111111111111111111111111111111
11111111111111111111111111111111111111111111111111111111111111111111111111111111111111111111111111111111111111
11111111111111111111111111111111111111111111111111111111111111111111111111111111111111111111111111111111111111
