11111111111111111111111111111111111111111111111111111111111111111111111111111111111111111111111111111111111111
11111111111111111111111111111100000000000000000000000000000000000000000000000000111111111111111111111111111111
11111111111111111111111111111100000000000000000000000000000000000000000000000000111111111111111111111111111111
11111111111111111111111111111100000000000000000000000000000000000000000000000000111111111111111111111111111111
11111111111111111111111111111100000000000000000000000000000000000000000000000000111111111111111111111111111111
11111111111111111111111111111100000000000000000000000000000000000000000000000000111111111111111111111111111111
11111111111111111111111111111100000000000000000000000000000000000000000000000000111111111111111111111111111111
11111111111111111111111111111100000000000000000000000000000000000000000000000000111111111111111111111111111111
11111111111111111111111111111100000000000000000000000000000000000000000000000000111111111111111111111111111111
11111111111111111111111111111100000000000000000000000000000000000000000000000000111111111111111111111111111111
11111111111111111111111111111100000000000000000000000000000000000000000000000000111111111111111111111111111111
11111111111111111111111111111100000000000000000000111111111100000000000000000000111111111111111111111111111111
11111111111111111111111111111100000000000000000000111111111100000000000000000000111111111111111111111111111111
11111111111111111111111111111100000000000000000000111111111100000000000000000000111111111111111111111111111111
11111111111111111111111111111100000000000000000000111111111100000000000000000000111111111111111111111111111111
11111111111111111111111111111100000000000000000000111111111100000000000000000000111111111111111111111111111111
11111111111111111111111111111100000000000000000000111111111100000000000000000000111111111111111111111111111111
11111111111111111111111111111100000000000000000000111111111100000000000000000000111111111111111111111111111111
11111111111111111111111111111100000000000000000000111111111100000000000000000000111111111111111111111111111111
11111111111111111111111111111100000000000000000000111111111100000000000000000000111111111111111111111111111111
11111111111111111111111111111100000000000000000000111111111100000000000000000000111111111111111111111111111111
1111111111000000000000000000000000000000000000000000000S000000000000000000000000000000000000000000003111111111
11111111110000000000000000000000000000000000000000000000000000000000000000000000000000000000000000003111111111
11111111110000000000000000000000000000000000000000000000000000000000000000000000000000000000000000003111111111
11111111110000000000000000000000000000000000000000000000000000000000000000000000000000000000000000003111111111
11111111110000000000000000000000000000000000000000000000000000000000000000000000000000000000000000003111111111
11111111110000000000000000000000000000000000000000000000000000000000000000000000000000000000000000003111111111
11111111110000000000000000000000000000000000000000000000000000000000000000000000000000000000000000003111111111
11111111110000000000000000000000000000000000000000000000000000000000000000000000000000000000000000003111111111
11111111110000000000000000000000000000000000000000000000000000000000000000000000000000000000000000003111111111
11111111110000000000000000000000000000000000000000000000000000000000000000000000000000000000000000003111111111
11111111112222222222222222222222222222222222222222222222222222222222222222222222222222222222222222221111111111
11111111111111111111111111111111111111111111111111111111111111111111111111111111111111111111111111111111111111
11111111111111111111111111111111111111111111111111111111111111111111111111111111111111111111111111111111111111
