NO ./path_to_the_north.xpm
SO ./paht_to_south.xpm
WE ./path_to_the_west.xpm
EA ./path_to_the_east.xpm

F 255,100,0
C 225,30,900

        1111111111111111111111111
        1000000000110000000000001
        1011000001110000000000001
10010000000000000000000011      
111111111011000001110000000000001
100000000111000001110111111111111
11110111111111011110000000001
11110111111111011101010010001
11000000110101011100000010001
10000000000000001100000010001
100000N0000000001101010010001
1100000111010101111101111000111
11110111 1110101 101111010001
11111111 1111111 111111111111
